*********************
*.*.*.*.*.*.*.*.*.*.*
*...................*
*.*.*.*.*.*.*.*.*.*.*
*...................*
*.*.*.*.*.*.*.*.*.*.*
*...................*
*.*.*.*.*.*.*.*.*.*.*
*...................*
*.*.*.*.*.*.*.*.*.*.*
*********************