*********************
*.........*.........*
*.........*.........*
*.........*.........*
*.........*.........*
*.........*.........*
*.........*.........*
*......... ..........*
*.........*.........*
*.........*.........*
*.........*.........*
*.........*.........*
*.........*.........*
*.........*.........*
*********************