*********************
*.........*.........*
*.........*.........*
*....*....*....*....*
*....*.........*....*
******....*....******
*....*.........*....*
*....*....*....*....*
*.........*.........*
*.........*.........*
*********************