*********************
*...................*
*..***.............*
*...........***....*
*.....*............*
*..*......*........*
*..............*...*
*..***.............*
*.........*........*
*..................*
*********************