*********************
*...................*
*.*****************.*
*.*...............*.*
*.*.*************.*.*
*.*.*...........*.*.*
*.*.*.*********.*.*.*
*.*.*.........*.*.*.*
*.***********.*.*.*.*
*.............*...*.*
*********************