*********************
*...................*
*.*****************.*
*.*...............*.*
*.*.*************.*.*
*.*.*...........*.*.*
*.*.*.*********.*.*.*
*.*.*.*.......*.*.*.*
*.*.*.*.*****.*.*.*.*
*.*.*.*.*...*.*.*.*.*
*.*.*.*.*.*.*.*.*.*.*
*.*.*.*.*...*.*.*.*.*
*.*.*.*.*****.*.*.*.*
*.*.*.*.......*.*.*.*
*.*.*.*********.*.*.*
*.*.*...........*.*.*
*.*.*************.*.*
*.*...............*.*
*.*****************.*
*...................*
*********************