*********************
*...................*
*..***...***...***..*
*..***...***...***..*
*...................*
*..***...***...***..*
*..***...***...***..*
*...................*
*..***...***...***..*
*..***...***...***..*
*...................*
*********************